11111111111111111111111111111
1000000000000000000000E000001
10000000000000000000000000001
10000000000000000000000000001
10000000000000000000000000001
10000000000000000000000000001
1P000000000000000000000000001
10000000000000000000000000001
10000000C00000000000000000001
10000000000000000000000000001
10000000000000000000000000001
10000000000000000000000000001
10000000000000000000000000001
11111111111111111111111111111

