11111111111111111111
1P000100000000C100E1
10000100000000010001
10000111110111111101
10000000000100000001
11111000000100000001
1C000000000100000001
10000000000100000001
10001111111111111101
10000000000000000001
11111111111111111111